name Uneven Dungeons of Doom
win 2
###################
#.................#
#......G........E.###################
#.................#
#..E..............#
#..........G......#
#.................#
#.................#
###################